Hero:hid_outlander_007_rs01_sr_t01	Jingle Jess	Event People	Holiday Heroes	
Hero:hid_outlander_007_sr_t01	Enforcer Grizzly	Outlanders		
Hero:hid_outlander_008_foundersf_sr_t01	Recon Scout Jess			Limited Edition Founder’s Pack
Hero:hid_outlander_008_foundersm_sr_t01	Recon Scout A.C.			Limited Edition Founder’s Pack
Hero:hid_outlander_008_sr_t01	Recon Scout Eagle Eye	Outlanders		
Hero:hid_outlander_009_sr_t01	Vanguard Southie	Outlanders		
Hero:hid_outlander_010_m_4thjuly_sr_t01	Old Glory A.C.	Event People	Springtime Heroes	
Hero:hid_outlander_010_m_sr_t01	Trailblaster A.C.	Expansion People	Storm Zone Heroes	
Hero:hid_outlander_010_sr_t01	Shockblaster Buzz	Outlanders		
Hero:hid_outlander_011_sr_t01	Gunblazer Southie	Expansion People	Scavenger Heroes	
Hero:hid_outlander_013_sr_t01	Fragment Flurry Jess	Event People	Holiday Heroes	
Hero:hid_outlander_013_stpatricks_sr_t01	Staredown Southie	Event People	Springtime Heroes	
Hero:hid_outlander_014_m_sr_t01	Flash A.C.	Event People	Chinese New Year Heroes	
Hero:hid_outlander_014_sr_t01	Fireflower Eagle Eye	Event People	Chinese New Year Heroes	
Hero:hid_outlander_015_f_v1_sr_t01	T.E.D.D. Shot Jess	Expansion People	CyberPunk Heroes	
Hero:hid_outlander_016_f_V1_sr_t01	Ambush Buzz	Expansion People	ShadowOps Heroes	
Hero:hid_outlander_016_m_V1_sr_t01	Shockgunner Grizzly	Expansion People	ShadowOps Heroes	
Hero:hid_outlander_017_m_V1_sr_t01	Wild Fragment Deadeye	Event People	Wild West Heroes	
Hero:hid_outlander_018_sr_t01	Sanguine Dusk	Event People	Fortnitemares Heroes	
Hero:hid_outlander_020_sr_t01	Valkyrie Rio	Outlanders		
Hero:hid_outlander_021_sr_t01	Ventura Ramirez	Outlanders		
Hero:hid_outlander_022_sr_t01	Subzero Zenith	Event People	Holiday Heroes	
Hero:hid_outlander_023_sr_t01	The Ice Queen	Event People	Holiday Heroes	
Hero:hid_outlander_024_sr_t01	Steel Wool Anthony	Event People	Steel Wool	
Hero:hid_outlander_025_pirateoutlander_sr_t01	Crossbones Barret	Event People	Pirate Heroes	
Hero:hid_outlander_026_bunnyoutlander_sr_t01	Cottontail Eagle Eye	Event People	Springtime Heroes	
Hero:hid_outlander_027_dinooutlander_sr_t01	Fossil Southie	Event People	Historic Heroes	
Hero:hid_outlander_028_retroscifistoryoutlander_sr_t01	Azalea Clark	Event People	Retro SciFi Heroes	
Hero:hid_outlander_029_retroscifioutlander_sr_t01	Cyberclops	Event People	Retro SciFi Heroes	
Hero:hid_outlander_030_radoutlander_sr_t01	Main Stage Quinn	Event People	Rad Heroes	
Hero:hid_outlander_031_halloweenoutlander_sr_t01	Willow	Event People	Fortnitemares Heroes	
Hero:hid_outlander_032_toyoutlander_sr_t01	Jilly Teacup	Event People	Holiday Heroes	
Hero:hid_outlander_033_kurohomura_sr_t01	Kurohomura	Promotional People	Battle Breakers!!	
Hero:hid_outlander_034_period_fleming_sr_t01	Undercover Buzz	Event People	Spy Heroes	
Hero:hid_outlander_035_palespooky_outlander_holiday_sr_t01	Red Willow	Event People	Holiday Heroes	
Hero:hid_outlander_036_dino_outlander_sr_t01	Parasaur Jess	Event People	Historic Heroes	
Hero:hid_outlander_037_fuzzy_bear_teddy_sr_t01	Metal Team Leader	Starter Packs	Metal Team Leader	
Hero:hid_outlander_038_clip_sr_t01	Cassie "Clip" Lipman	Event People	Homebase Heroes	
Hero:hid_outlander_039_female_gumshoe_sr_t01	Gumshoe	Event People	Art Deco Heroes
Hero:hid_outlander_040_assemblek_sr_t01		Robo-Kevin		Starter Packs		Robo-Kevin
Hero:hid_outlander_myth02_sr_t01	Ragnarok	Event People	Road Trip Heroes	
Hero:hid_outlander_myth03_sr_t01	Field Agent Rio	Event People	Spy Heroes	
Hero:hid_outlander_punchdamage_sr_t01	Striker A.C.	Outlanders		
Hero:hid_outlander_punchphase_sr_t01	Shock Specialist A.C.	Outlanders		
Hero:hid_outlander_sony_sr_t01	Trailblazer A.C.			Pre-Order bonus for purchasing Fortnite on the Playstation 4 Console.
Hero:hid_outlander_spherefragment_sr_t01	Trailblazer Quinn	Outlanders		
Hero:hid_outlander_xbox_sr_t01	Trailblazer Jess			Pre-Order bonus for purchasing Fortnite on the Xbox One Console.
Hero:hid_outlander_zonefragment_sr_t05	Phase Scout Jess	Outlanders		
Hero:hid_outlander_zoneharvest_blockbuster_sr_t01	Archaeolo-Jess	Event People	Blockbusters Heroes	
Hero:hid_outlander_zoneharvest_sr_t01	Pathfinder Jess	Outlanders		
Hero:hid_outlander_zoneharvesthw_sr_t03	Bloodfinder A.C.	Event People	Fortnitemares Heroes	
Hero:hid_outlander_zonepistol_sr_t01	Ranger Deadeye	Outlanders		
Hero:hid_outlander_zonepistolhw_sr_t01	Beetlejess	Event People	Fortnitemares Heroes	
